1111111111111111111
1E00000000000000001
1000000000000000S01
1000000000000000001
1000000000000000001
10P00000000000000C1
1000000000000000CC1
1111111111111111111